############################
#                          #
#       Y Y Y Y Y Y        #
#        Y Y Y Y Y         #
#         Y Y Y Y          #
#          Y Y Y           #
#           Y Y            #
#                          #
#                          #
#                          #
#                          #
#                          #
#                          #
#                          #
#                          #
#            .             #
#                          #
#                          #
#                          #
#                          #
#                          #
#                          #
#                          #
#                    .     #
#                          #
#                          #
#                          #
#                          #
#                          #
#            U             #
#                          #
#                          #
############################
